MTHSIG13	testaddsecurityconstraint test add secur constraint 
MTHSIG14	validateelementsequ valid element sequenc 
MTHSIG11	testaddexceptiontyp test add except type 
MTHSIG12	testadderrorcod test add error code 
COMMENTS	unit test link webxmlutil web xml util 
CLASSES	webxmlutilstest web xml util test 
METHODS	setup set testsetdisplaynam test set displai testsetdescript test set descript testaddcontextparam test add context testaddfilt test add filter testaddfilteratpositionwithdispatch test add filter posit dispatch testaddfilteratposit test add filter posit testaddlisten test add listen testaddservlet test add servlet testsetsessiontimeout test set session timeout testaddwelcomefil test add file testaddexceptiontyp test add except type testadderrorcod test add error code testaddsecurityconstraint test add secur constraint validateelementsequ valid element sequenc 
MTHSIG4	testaddfilt test add filter 
MTHSIG5	testaddfilteratpositionwithdispatch test add filter posit dispatch 
MTHSIG6	testaddfilteratposit test add filter posit 
MTHSIG7	testaddlisten test add listen 
MTHSIG0	setup set 
MTHSIG1	testsetdisplaynam test set displai 
PACKAGE	springframework roo support util 
MTHSIG2	testsetdescript test set descript 
MTHSIG3	testaddcontextparam test add context 
MTHSIG10	testaddwelcomefil test add file 
VARIABLES	webxml web xml builder displayel displai element descriptionel descript element contextparamel context element filterel filter element filtermap filter map initparam init param filterel filter element filtermap filter map dispatch filterel filter element filtermap filter map listenerel listen element servletel servlet element servletmap servlet map initparam init param timeel time element welcomefileel file element errorpageel error element errorpageel error element securityconstraintel secur constraint element webresourcecollect web resourc collect authconstraint constraint userdataconstraint user data constraint content 
MTHSIG8	testaddservlet test add servlet 
MTHSIG9	testsetsessiontimeout test set session timeout 
