VARSIG7	jndidatasourc jndi data sourc 
VARSIG6	sqlexcept sql except 
VARSIG9	displayaddon displai add on 
VARSIG8	map map 
VARSIG3	displayaddon displai add on 
VARSIG2	map map 
VARSIG5	displayaddon displai add on 
VARSIG4	properti prop 
COMMENTS	implement link connectionprovid connect provid properti user password requir connect 
CLASSES	connectionproviderimpl connect provid impl 
VARSIG1	sqlexcept sql except 
VARSIG0	connect connect 
METHODS	closeconnect close connect getconnect connect getconnect connect getconnectionviajndidatasourc connect jndi data sourc getprop prop 
MTHSIG4	getprop prop map map 
VARSIG11	map map 
VARSIG10	except 
MTHSIG0	closeconnect close connect connect connect 
MTHSIG1	getconnect connect map map displayaddon displai add on 
PACKAGE	springframework roo addon dbre jdbc 
MTHSIG2	getconnect connect properti prop displayaddon displai add on 
MTHSIG3	getconnectionviajndidatasourc connect jndi data sourc jndidatasourc jndi data sourc map map displayaddon displai add on 
VARIABLES	connect map displayaddon displai add on prop displayaddon displai add on jndidatasourc jndi data sourc map displayaddon displai add on map password user jdbcdrivermanag jdbc driver manag driverclassnam driver driver context datasourc data sourc prop 
