VARSIG7	javasymbolnam symbol methodnam 
VARSIG6	map fieldmetadata field metadata methodmetadata metadata locatedfieldsandmut locat field mutat 
VARSIG9	javatyp type javatyp type 
VARSIG8	list javatyp type paramtyp type 
VARSIG3	jsfannotationvalu jsf annot valu annotationvalu annot valu 
VARSIG2	physicaltypemetadata physic type metadata governorphysicaltypemetadata governor physic type metadata 
VARSIG5	plural 
VARSIG4	memberdetail member detail memberdetail member detail 
COMMENTS	metadata link roojsfmanagedbean roo jsf manag bean add method creat represent desir output 
VARSIG1	javatyp type aspectnam aspect 
VARSIG0	identifi 
MTHSIG4	tostr 
VARSIG12	metadataidentificationstr metadata identif 
MTHSIG5	getmetadataidentifertyp metadata identif type 
VARSIG11	metadataidentificationstr metadata identif 
MTHSIG6	createidentifi creat identifi javatyp type javatyp type path path 
VARSIG10	path path 
MTHSIG7	getjavatyp type metadataidentificationstr metadata identif 
MTHSIG0	jsfmanagedbeanformmetadata jsf manag bean form metadata identifi javatyp type aspectnam aspect physicaltypemetadata physic type metadata governorphysicaltypemetadata governor physic type metadata jsfannotationvalu jsf annot valu annotationvalu annot valu memberdetail member detail memberdetail member detail plural map fieldmetadata field metadata methodmetadata metadata locatedfieldsandmut locat field mutat 
MTHSIG1	getformmodelfield form model field 
PACKAGE	springframework roo addon jsf 
MTHSIG2	populateformmodel popul form model 
MTHSIG3	methodexist exist javasymbolnam symbol methodnam list javatyp type paramtyp type 
VARSIG13	metadataidentificationstr metadata identif 
MTHSIG8	getpath path metadataidentificationstr metadata identif 
MTHSIG9	isvalid valid metadataidentificationstr metadata identif 
CLASSES	jsfmanagedbeanformmetadata jsf manag bean form metadata 
METHODS	jsfmanagedbeanformmetadata jsf manag bean form metadata getformmodelfield form model field populateformmodel popul form model methodexist exist tostr getmetadataidentifertyp metadata identif type createidentifi creat identifi getjavatyp type getpath path isvalid valid 
VARIABLES	identifi aspectnam aspect governorphysicaltypemetadata governor physic type metadata annotationvalu annot valu memberdetail member detail plural locatedfieldsandmut locat field mutat methodnam paramtyp type javatyp type path metadataidentificationstr metadata identif metadataidentificationstr metadata identif metadataidentificationstr metadata identif type type entitytyp entiti type locatedfieldsandmut locat field mutat fieldnam field field panelgrid panel grid import fieldbuild field builder tsc 
