VARSIG7	entri javatyp type javatyp type entri 
VARSIG6	map javatyp type domaintypeplur domain type plural 
VARSIG9	servicelayermethod servic layer 
VARSIG8	servicelayermethod servic layer 
VARSIG3	memberdetail member detail governordetail governor detail 
VARSIG2	physicaltypemetadata physic type metadata governorphysicaltypemetadata governor physic type metadata 
VARSIG5	serviceannotationvalu servic annot valu annotationvalu annot valu 
VARSIG4	map javatyp type javatyp type domaintypetoidtypemap domain type type map 
COMMENTS	metadata servic user project constant field constructor identifi requir aspectnam aspect requir governorphysicaltypemetadata governor physic type metadata requir governordetail governor detail requir domaintypetoidtypemap domain type type map requir annotationvalu annot valu requir domaintypeplur domain type plural creat represent desir output return metadata declar servic declar domaintyp domain type domain type manag idtyp type plural domain type type plural isn requir declar governor don governor declar 
VARSIG1	javatyp type aspectnam aspect 
VARSIG0	identifi 
VARSIG17	metadataidentificationstr metadata identif 
MTHSIG4	createidentifi creat identifi javatyp type javatyp type logicalpath logic path path 
VARSIG12	plural 
MTHSIG5	getjavatyp type metadataidentificationstr metadata identif 
VARSIG11	javatyp type idtyp type 
MTHSIG6	getpath path metadataidentificationstr metadata identif 
VARSIG10	javatyp type domaintyp domain type 
MTHSIG7	isvalid valid metadataidentificationstr metadata identif 
MTHSIG0	serviceinterfacemetadata servic metadata identifi javatyp type aspectnam aspect physicaltypemetadata physic type metadata governorphysicaltypemetadata governor physic type metadata memberdetail member detail governordetail governor detail map javatyp type javatyp type domaintypetoidtypemap domain type type map serviceannotationvalu servic annot valu annotationvalu annot valu map javatyp type domaintypeplur domain type plural 
VARSIG16	metadataidentificationstr metadata identif 
MTHSIG1	getmethod servicelayermethod servic layer javatyp type domaintyp domain type javatyp type idtyp type plural 
VARSIG15	metadataidentificationstr metadata identif 
PACKAGE	springframework roo addon layer servic 
MTHSIG2	getserviceannotationvalu servic annot valu 
VARSIG14	logicalpath logic path path 
MTHSIG3	getmetadataidentifertyp metadata identif type 
VARSIG13	javatyp type javatyp type 
MTHSIG8	tostr 
CLASSES	serviceinterfacemetadata servic metadata 
METHODS	serviceinterfacemetadata servic metadata getmethod getserviceannotationvalu servic annot valu getmetadataidentifertyp metadata identif type createidentifi creat identifi getjavatyp type getpath path isvalid valid tostr 
VARIABLES	identifi aspectnam aspect governorphysicaltypemetadata governor physic type metadata governordetail governor detail domaintypetoidtypemap domain type type map annotationvalu annot valu domaintypeplur domain type plural entri domaintyp domain type idtyp type plural javatyp type path metadataidentificationstr metadata identif metadataidentificationstr metadata identif metadataidentificationstr metadata identif type type bodi governordetail governor detail annotationvalu annot valu domaintyp domain type plural methodnam tsc 
