VARSIG7	element repositoryel repositori element 
VARSIG6	element webflowdependencyel web flow depend element 
VARSIG9	templatefilenam templat file 
VARSIG8	flownam flow 
VARSIG3	element 
VARSIG2	element root 
VARSIG5	element root 
VARSIG4	document document 
COMMENTS	web flow configur oper field link webflowoper web flow oper installwebflow instal web flow 
CLASSES	webflowoperationsimpl web flow oper impl 
VARSIG1	document document 
VARSIG0	flownam flow 
METHODS	iswebflowinstallationposs web flow instal installwebflow instal web flow installwebflowconfigur instal web flow configur updateconfigur updat configur getflowid flow copytempl copi templat 
MTHSIG4	getflowid flow flownam flow 
MTHSIG5	copytempl copi templat templatefilenam templat file resolvedtargetdirectorypath resolv target directori path 
VARSIG11	ioexcept except 
VARSIG10	resolvedtargetdirectorypath resolv target directori path 
MTHSIG0	iswebflowinstallationposs web flow instal 
MTHSIG1	installwebflow instal web flow flownam flow 
PACKAGE	springframework roo addon web flow 
MTHSIG2	installwebflowconfigur instal web flow configur 
MTHSIG3	updateconfigur updat configur 
VARIABLES	flownam flow document root document root webflowdependencyel web flow depend element repositoryel repositori element flownam flow templatefilenam templat file resolvedtargetdirectorypath resolv target directori path filemanag file manag jspoper jsp oper menuoper menu oper pathresolv path resolv projectoper project oper tilesoper tile oper webmvcoper web mvc oper flowid flow webrelativeflowpath web rel flow path resolvedflowpath resolv flow path resolvedflowdefinitionpath resolv flow definit path flowmenucategori flow menu categori flowmenunam flow menu resolvedspringconfigpath resolv spring config path webmvcconfigpath web mvc config path importswf swf configur focusedmodulenam focus modul dependencyel depend element repositoryel repositori element 
