MTHSIG28	isallowablereturntype allowable type javatype type type
MTHSIG29	iscommontype common type javatype type type
MTHSIG26	checkprimitive check primitive javatype type type
MTHSIG27	isallowablereturntype allowable type methodmetadata metadata
MTHSIG24	buildtype build type gwttype gwt type desttype dest type classorinterfacetypedetails type details templateclass template list memberholdingtypedetails member holding type details extendstypes types modulename module
MTHSIG25	displaywarning display warning warning
MTHSIG22	isdomainobject domain object javatype type type
MTHSIG23	createabstractbuilder create builder classorinterfacetypedetailsbuilder type details builder concreteclass concrete list memberholdingtypedetails member holding type details extendstypesdetails types details modulename module
MTHSIG4	lookupentityfromrequest lookup entity request classorinterfacetypedetails type details request
VARSIG78	classorinterfacetypedetails type details ptmd
MTHSIG5	lookupentityfromlocator lookup entity locator classorinterfacetypedetails type details locator
VARSIG77	javatype type returntype type
MTHSIG6	lookuptargetservicefromrequest lookup target service request classorinterfacetypedetails type details request
VARSIG76	javatype type type
MTHSIG7	lookuptargetfromx lookup target classorinterfacetypedetails type details annotatedtype annotated type javatype type annotations
VARSIG75	javatype type type
MTHSIG0	getgwtsideleaftype gwt side leaf type javatype type returntype type javatype type governortype governor type requesttype request type convertprimitive convert primitive
MTHSIG1	lookuprequestfromproxy lookup request proxy classorinterfacetypedetails type details proxy
MTHSIG2	lookupproxyfromrequest lookup proxy request classorinterfacetypedetails type details request
MTHSIG3	lookupentityfromproxy lookup entity proxy classorinterfacetypedetails type details proxy
VARSIG79	classorinterfacetypedetails type details ptmd
MTHSIG20	ismethodreturntypeinsourcepath type source path methodmetadata metadata memberholdingtypedetails member holding type details memberholdingtypedetail member holding type detail iterable javapackage sourcepackages source packages
VARSIG70	methodmetadata metadata
MTHSIG21	istypeinanysourcepackage type source javatype type type iterable javapackage sourcepackages source packages
MTHSIG8	lookuprequestfromentity lookup request entity classorinterfacetypedetails type details entity
VARSIG74	javatype type type
MTHSIG9	lookupproxyfromentity lookup proxy entity classorinterfacetypedetails type details entity
VARSIG73	javatype type type
VARSIG72	javatype type type
VARSIG71	javatype type type
MTHSIG39	isdomainobject domain object javatype type returntype type classorinterfacetypedetails type details ptmd
MTHSIG37	isrequestfactorycompatible request factory compatible javatype type type
MTHSIG38	ispublicaccessor accessor methodmetadata metadata
MTHSIG35	isenum classorinterfacetypedetails type details ptmd
MTHSIG36	isembeddable embeddable classorinterfacetypedetails type details ptmd
MTHSIG33	isentity entity javatype type type
MTHSIG34	iscollectiontype collection type javatype type returntype type
METHODS	getgwtsideleaftype gwt side leaf type lookuprequestfromproxy lookup request proxy lookupproxyfromrequest lookup proxy request lookupentityfromproxy lookup entity proxy lookupentityfromrequest lookup entity request lookupentityfromlocator lookup entity locator lookuptargetservicefromrequest lookup target service request lookuptargetfromx lookup target lookuprequestfromentity lookup request entity lookupproxyfromentity lookup proxy entity lookupxfromentity lookup entity getextendstypes types getgwtmodulexml gwt module xml buildtype build type getsourcepackages source packages addsourcepath add source path anyexistingsourcepathsincludepath existing source paths include path getgwtxmldocument gwt xml document getproxymethods proxy methods isvalidmethodreturntype valid type ismethodreturntypeinsourcepath type source path istypeinanysourcepackage type source isdomainobject domain object createabstractbuilder create builder buildtype build type displaywarning display warning checkprimitive check primitive isallowablereturntype allowable type isallowablereturntype allowable type iscommontype common type istypecommon type common isenum isprimitive primitive isentity entity iscollectiontype collection type isenum isembeddable embeddable isrequestfactorycompatible request factory compatible ispublicaccessor accessor isdomainobject domain object resolvetypes resolve types convertmodifier convert modifier getservicelocator service locator
VARSIG67	exception
VARSIG66	classorinterfacetypedetailsbuilder type details builder innertypebuilder type builder
VARSIG65	javatype type innertypename type
VARSIG64	annotatedjavatype annotated type
VARSIG69	javatype type type
VARSIG68	warning
MTHSIG31	isenum javatype type type
MTHSIG32	isprimitive primitive javatype type type
MTHSIG30	istypecommon type common javatype type type
VARSIG63	methodmetadatabuilder metadata builder methodbuilder builder
VARSIG62	javasymbolname symbol methodname
VARSIG61	fieldmetadatabuilder field metadata builder fieldbuilder field builder
VARSIG60	javasymbolname symbol fieldname field
COMMENTS	basic implementation link gwttypeservice gwt type service constants fields type arg client side domain type domain type list set returns domain type list list returntype type projectmetadata project metadata governortype governor type gwt side leaf type javatype type behaviour project type collection project type type consist concrete type depend
VARSIG19	modulename module
VARSIG18	javatype type javatype type
VARSIG17	classorinterfacetypedetails type details childtype child type
VARSIG12	classorinterfacetypedetails type details entity
VARSIG11	javatype type annotations
VARSIG10	classorinterfacetypedetails type details annotatedtype annotated type
VARSIG16	classorinterfacetypedetails type details cid
VARSIG15	javatype type annotations
VARSIG14	classorinterfacetypedetails type details entity
VARSIG13	classorinterfacetypedetails type details entity
MTHSIG17	getgwtxmldocument gwt xml document gwtmodulecanonicalpath gwt module canonical path
MTHSIG18	getproxymethods proxy methods classorinterfacetypedetails type details governortypedetails governor type details
MTHSIG15	addsourcepath add source path sourcepath source path modulename module
MTHSIG16	anyexistingsourcepathsincludepath existing source paths include path sourcepath source path iterable element sourceelements source elements
MTHSIG13	buildtype build type gwttype gwt type type list classorinterfacetypedetails type details templatetypedetails template type details modulename module
MTHSIG14	getsourcepackages source packages modulename module
MTHSIG11	getextendstypes types classorinterfacetypedetails type details childtype child type
MTHSIG12	getgwtmodulexml gwt module xml modulename module
MTHSIG19	isvalidmethodreturntype valid type methodmetadata metadata memberholdingtypedetails member holding type details memberholdingtypedetail member holding type detail
VARSIG88	modulename module
VARSIG87	builder
VARSIG86	javatype type genericparamtype type
VARSIG81	methodmetadata metadata
MTHSIG10	lookupxfromentity lookup entity classorinterfacetypedetails type details entity javatype type annotations
VARSIG80	javatype type type
VARIABLES	returntype type governortype governor type requesttype request type convertprimitive convert primitive proxy request proxy request locator request annotatedtype annotated type annotations entity entity entity annotations cid childtype child type javatype type modulename module filedetails file details type templatetypedetails template type details modulename module templatetypedetail template type detail modulename module sourcepathelement source path element sourcepath source path modulename module sourcepath source path sourceelements source elements sourceelement source element gwtmodulecanonicalpath gwt module canonical path publicid systemid system governortypedetails governor type details memberholdingtypedetails member holding type details memberholdingtypedetail member holding type detail memberholdingtypedetail member holding type detail sourcepackages source packages type sourcepackages source packages sourcepackage source type concreteclass concrete extendstypesdetails types details modulename module extendstypedetails type details constructor type typetype type type paramname desttype dest type templateclass template extendstypes types modulename module fieldname field fieldbuilder field builder methodname methodbuilder builder innertypename type innertypebuilder type builder warning type type type type type type type returntype type ptmd ptmd type returntype type ptmd typed genericparamtype type builder modulename module logger path filemanager file manager gwtfilemanager gwt file manager memberdetailsscanner member details scanner metadataservice metadata service persistencememberlocator persistence member locator projectoperations project operations typelocationservice type location service warnings warningtimer warning timer elementtype element type convertedjavatype converted type ptmd typedetails type details proxy annotation attributevalue attribute servicenametype service type annotation attributevalue attribute proxytype proxy type annotation attributevalue attribute targettype target type annotationmetadata annotation metadata attributevalue attribute extendstypes types supertypeid type supertype type logicalpath logical path gwtmodulexml gwt module xml paths watchedmethods watched methods typestobewritten types written gwtxmldoc gwt xml doc gwtxmlroot gwt xml root toplevelpackage top level sourcepackages source packages relativepackage relative gwtxmlpath gwt xml path gwtxmldoc gwt xml doc gwtxmlroot gwt xml root sourceelements source elements firstsourceelement source element newsourceelement source element builder inputstream input stream proxymethods proxy methods memberdetails member details returntype type propertyname property returntype type insourcepath source path ptmd concretetype concrete type abstractname abstracttype type abstractid cidbuilder cid builder abstractconstructor constructor typemap type map newtype type parametertypes parameter types typeparam type bodybuilder body builder types templateclassbuilder template builder abstractclassbuilder builder fieldstoremove fields remove abstractfieldbuilder field builder methodstoremove methods remove params abstractmethodbuilder builder builder interfaceinnertypebuilder type builder annotationmetadata annotation metadata typemap type map typecountmatch type count match
VARSIG85	javatype type typed
VARSIG84	javatype type
VARSIG83	classorinterfacetypedetails type details ptmd
VARSIG82	javatype type returntype type
VARSIG39	methodmetadata metadata
VARSIG34	systemid system
VARSIG33	publicid
VARSIG32	gwtmodulecanonicalpath gwt module canonical path
VARSIG31	element sourceelement source element
VARSIG38	methodmetadata metadata
VARSIG37	memberholdingtypedetails member holding type details memberholdingtypedetails member holding type details
PACKAGE	springframework roo addon gwt
VARSIG36	classorinterfacetypedetails type details governortypedetails governor type details
VARSIG35	exception
VARSIG30	iterable element sourceelements source elements
CLASSES	gwttypeserviceimpl gwt type service impl
VARSIG29	sourcepath source path
VARSIG28	modulename module
VARSIG23	modulename module
VARSIG22	list classorinterfacetypedetails type details templatetypedetails template type details
VARSIG21	gwttype gwt type type
VARSIG20	filedetails file details filedetails file details
VARSIG27	sourcepath source path
VARSIG26	element sourcepathelement source path element
VARSIG25	modulename module
VARSIG24	classorinterfacetypedetails type details templatetypedetail template type detail
VARSIG7	classorinterfacetypedetails type details request
VARSIG6	classorinterfacetypedetails type details proxy
VARSIG9	classorinterfacetypedetails type details request
VARSIG8	classorinterfacetypedetails type details locator
VARSIG3	convertprimitive convert primitive
VARSIG2	requesttype request type
VARSIG5	classorinterfacetypedetails type details request
VARSIG4	classorinterfacetypedetails type details proxy
VARSIG1	javatype type governortype governor type
VARSIG0	javatype type returntype type
VARSIG56	gwttype gwt type desttype dest type
VARSIG55	javasymbolname symbol paramname
VARSIG54	javatype type typetype type type
VARSIG53	annotatedjavatype annotated type type
VARSIG59	modulename module
VARSIG58	list memberholdingtypedetails member holding type details extendstypes types
VARSIG57	classorinterfacetypedetails type details templateclass template
MTHSIG42	getservicelocator service locator modulename module
MTHSIG40	resolvetypes resolve types javatype type javatype type typed
MTHSIG41	convertmodifier convert modifier builder
VARSIG52	constructormetadata constructor metadata constructor
VARSIG51	memberholdingtypedetails member holding type details extendstypedetails type details
VARSIG50	modulename module
VARSIG45	iterable javapackage sourcepackages source packages
VARSIG44	javatype type type
VARSIG43	iterable javapackage sourcepackages source packages
VARSIG42	memberholdingtypedetails member holding type details memberholdingtypedetail member holding type detail
VARSIG49	list memberholdingtypedetails member holding type details extendstypesdetails types details
VARSIG48	classorinterfacetypedetailsbuilder type details builder concreteclass concrete
VARSIG47	javatype type type
VARSIG46	javapackage sourcepackage source
VARSIG41	methodmetadata metadata
VARSIG40	memberholdingtypedetails member holding type details memberholdingtypedetail member holding type detail
