VARSIG39	declaredbymetadataid declared metadata
MTHSIG4	iscontrolleravailable controller
VARSIG34	javatype type controller
MTHSIG5	isinstalllanguagecommandavailable install language command
VARSIG33	logicalpath logical path webapppath webapp path
MTHSIG6	isprojectavailable project
VARSIG32	backup
MTHSIG7	installcommonviewartefacts install common view artefacts modulename module
VARSIG31	logicalpath logical path webapppath webapp path
MTHSIG0	getfolderandmapping folder mapping preferredmapping preferred mapping javatype type controller
VARSIG38	declaredbymetadataid declared metadata
MTHSIG1	getname
VARSIG37	foldername folder
PACKAGE	springframework roo addon web mvc jsp
MTHSIG2	isinstalledinmodule installed module modulename module
VARSIG36	logicalpath logical path webapppath webapp path
MTHSIG3	ismvcinstallationpossible mvc installation
VARSIG35	preferredmapping preferred mapping
MTHSIG20	cleanviewname clean view viewname view
MTHSIG21	installcommonviewartefacts install common view artefacts
MTHSIG8	installview install view path viewname view title category logicalpath logical path webapppath webapp path
VARSIG30	relativeurl relative url
MTHSIG9	installview install view path viewname view title category document document logicalpath logical path webapppath webapp path
CLASSES	jspoperationsimpl jsp operations impl
VARSIG29	logicalpath logical path webapppath webapp path
VARSIG28	registerstaticcontroller register controller
METHODS	getfolderandmapping folder mapping getname isinstalledinmodule installed module ismvcinstallationpossible mvc installation iscontrolleravailable controller isinstalllanguagecommandavailable install language command isprojectavailable project installcommonviewartefacts install common view artefacts installview install view installview install view installview install view installview install view registerstaticspringmvccontroller register spring mvc controller updatetags update tags createmanualcontroller create manual controller getindexmethod gethttppostmethod http post updateconfiguration update configuration installi install cleanpath clean path cleanviewname clean view installcommonviewartefacts install common view artefacts
VARSIG23	exception
VARSIG22	logicalpath logical path webapppath webapp path
VARSIG21	registerstaticcontroller register controller
VARSIG20	document document
VARSIG27	category
VARSIG26	title
VARSIG25	foldername folder
VARSIG24	javasymbolname symbol viewname view
VARSIG7	title
VARSIG6	viewname view
VARSIG9	logicalpath logical path webapppath webapp path
VARSIG8	category
VARSIG3	modulename module
VARSIG2	modulename module
VARSIG5	path
VARSIG4	exception
COMMENTS	implementation link jspoperations jsp operations constants returns folder mapping preferred maaping preferredmapping preferred mapping blank controller controller type required pair defaults fields install tiles config install styles install styles install layout install common view files install tags install language creates spring mvc view viewname view bare logical view required foldername folder folder create view empty start slash title title category menu category list view required registerstaticcontroller register controller register controller spring mvc configuration file probe common web artifacts exist install needed update application specific resource bundle translation add menu item add view definition update spring mvc config file registers spring mvc controller handle relative url relativeurl relative url relative url handle required leading slash required update tags creates spring mvc controller request mappings assigned commence create annotation requestmapping request mapping myobject add http post add create type definition create annotation controller adds tiles maven dependencies updates mvc config include tiles view support add tiles dependencies pom add config mvc app context tiles configured install message bundle country special english locale install flag country setup language definition languages jspx record add languages implemented add ons
VARSIG19	category
VARSIG1	javatype type controller
VARSIG18	title
VARSIG0	preferredmapping preferred mapping
VARSIG17	viewname view
VARSIG12	title
VARSIG11	viewname view
VARSIG10	path
VARSIG16	path
VARSIG15	logicalpath logical path webapppath webapp path
VARSIG14	document document
VARSIG13	category
MTHSIG17	updateconfiguration update configuration
MTHSIG18	installi install logicalpath logical path webapppath webapp path
MTHSIG15	getindexmethod foldername folder declaredbymetadataid declared metadata
MTHSIG16	gethttppostmethod http post declaredbymetadataid declared metadata
MTHSIG13	updatetags update tags backup logicalpath logical path webapppath webapp path
MTHSIG14	createmanualcontroller create manual controller javatype type controller preferredmapping preferred mapping logicalpath logical path webapppath webapp path
MTHSIG11	installview install view javasymbolname symbol viewname view foldername folder title category registerstaticcontroller register controller logicalpath logical path webapppath webapp path
MTHSIG12	registerstaticspringmvccontroller register spring mvc controller relativeurl relative url logicalpath logical path webapppath webapp path
MTHSIG19	cleanpath clean path path
VARSIG45	ioexception exception
VARSIG44	ioexception exception
VARSIG43	logicalpath logical path webapppath webapp path
VARSIG42	
VARSIG47	viewname view
VARSIG46	path
MTHSIG10	installview install view path viewname view title category document document registerstaticcontroller register controller logicalpath logical path webapppath webapp path
VARIABLES	preferredmapping preferred mapping controller modulename module modulename module path viewname view title category webapppath webapp path path viewname view title category document webapppath webapp path path viewname view title category document registerstaticcontroller register controller webapppath webapp path viewname view foldername folder title category registerstaticcontroller register controller webapppath webapp path relativeurl relative url webapppath webapp path backup webapppath webapp path controller preferredmapping preferred mapping webapppath webapp path foldername folder declaredbymetadataid declared metadata declaredbymetadataid declared metadata dependencyelement dependency element bean webapppath webapp path path viewname view http servlet request http servlet response foldername folder mapping typenamelower type backupoperations backup operations nsupport support menuoperations menu operations pathresolver path resolver projectoperations project operations propfileoperations prop file operations tilesoperations tiles operations typemanagementservice type management service uaaregistrationservice uaa registration service webmvcoperations web mvc operations webapppath web app path webapppath webapp path ndirectory directory projectname project cleanedpath cleaned path cleanedviewname cleaned view lcviewname view viewfile view file pathresolver path resolver lcviewname view messagecode message code relativeurl relative url mvcconfig mvc config document prefixedurl prefixed url sibling view folderandmapping folder mapping foldername folder resourceidentifier resource identifier declaredbymetadataid declared metadata methods typeannotations type annotations requestmappingattributes request mapping attributes requestmapping request mapping controllerattributes controller attributes controllerannotation controller annotation cidbuilder cid builder indexmethodannotations annotations bodybuilder body builder indexmethodbuilder builder postmethodannotations post annotations postmethodattributes post attributes postparamtypes post types idparamannotation annotation postparamnames post names postmethodbuilder post builder configuration dependencies springdependencies spring dependencies mvcconfig mvc config mvcconfigdocument mvc config document beans configdoc config doc configelement config element tilesconfig tiles config importedbean imported bean targetdirectory target directory messagebundle message bundle flaggraphic flag graphic footerfilelocation footer file location footer span bundlesymbolicname bundle symbolic
VARSIG41	element bean
VARSIG40	element dependencyelement dependency element
