VARSIG7	physicaltypemetadata physical type metadata governorphysicaltypemetadata governor physical type metadata
VARSIG6	javatype type aspectname aspect
VARSIG9	map javatype type javatype type domaintypetoidtypemap domain type type map
VARSIG8	memberdetails member details governordetails governor details
VARSIG3	metadataidentificationstring metadata identification
VARSIG2	metadataidentificationstring metadata identification
VARSIG5	identifier
VARSIG4	metadataidentificationstring metadata identification
COMMENTS	metadata service user project constructor identifier required aspectname aspect required governorphysicaltypemetadata governor physical type metadata required governordetails governor details required domaintypetoidtypemap domain type type map required annotationvalues annotation values required domaintypeplurals domain type plurals create representation desired output returns metadata declaring service declare domaintype domain type domain type managed idtype type plural domain type type plural isn required declared governor don governor declares
VARSIG1	logicalpath logical path path
VARSIG0	javatype type javatype type
VARSIG17	plural
MTHSIG4	isvalid valid metadataidentificationstring metadata identification
VARSIG12	entry javatype type javatype type entry
MTHSIG5	serviceinterfacemetadata service metadata identifier javatype type aspectname aspect physicaltypemetadata physical type metadata governorphysicaltypemetadata governor physical type metadata memberdetails member details governordetails governor details map javatype type javatype type domaintypetoidtypemap domain type type map serviceannotationvalues service annotation values annotationvalues annotation values map javatype type domaintypeplurals domain type plurals
VARSIG11	map javatype type domaintypeplurals domain type plurals
MTHSIG6	getmethod servicelayermethod service layer javatype type domaintype domain type javatype type idtype type plural
VARSIG10	serviceannotationvalues service annotation values annotationvalues annotation values
MTHSIG7	getserviceannotationvalues service annotation values
MTHSIG0	createidentifier create identifier javatype type javatype type logicalpath logical path path
VARSIG16	javatype type idtype type
MTHSIG1	getjavatype type metadataidentificationstring metadata identification
VARSIG15	javatype type domaintype domain type
PACKAGE	springframework roo addon layers service
MTHSIG2	getmetadataidentifertype metadata identifer type
VARSIG14	servicelayermethod service layer
MTHSIG3	getpath path metadataidentificationstring metadata identification
VARSIG13	servicelayermethod service layer
MTHSIG8	tostring
CLASSES	serviceinterfacemetadata service metadata
METHODS	createidentifier create identifier getjavatype type getmetadataidentifertype metadata identifer type getpath path isvalid valid serviceinterfacemetadata service metadata getmethod getserviceannotationvalues service annotation values tostring
VARIABLES	javatype type path metadataidentificationstring metadata identification metadataidentificationstring metadata identification metadataidentificationstring metadata identification identifier aspectname aspect governorphysicaltypemetadata governor physical type metadata governordetails governor details domaintypetoidtypemap domain type type map annotationvalues annotation values domaintypeplurals domain type plurals entry domaintype domain type idtype type plural body type type annotationvalues annotation values governordetails governor details domaintype domain type plural methodname builder
