VARSIG39	metadataidentificationstr metadata identif 
MTHSIG4	transformxml transform xml document document 
VARSIG34	gwttype gwt type gwttype gwt type 
MTHSIG5	getrequestmethod request destinationmetadataid destin metadata methodmetadata metadata methodmetadata meta data 
VARSIG33	gwttype gwt type gwttype gwt type 
MTHSIG6	getrequestmethod request destinationmetadataid destin metadata methodmetadata metadata methodmetadata meta data javatyp type methodreturntyp type 
VARSIG32	javatyp type methodreturntyp type 
MTHSIG7	getdestinationmetadataid destin metadata gwttype gwt type gwttype gwt type 
VARSIG31	methodmetadata metadata methodmetadata meta data 
MTHSIG0	gwtmetadata gwt metadata identifi classorinterfacetypedetail type detail governortypedetail governor type detail projectmetadata project metadata projectmetadata project metadata list methodmetadata metadata proxymethod proxi method list methodmetadata metadata requestmethod request method methodmetadata metadata findallmethod find methodmetadata metadata findmethod find methodmetadata metadata findentriesmethod find entri methodmetadata metadata countmethod count 
VARSIG38	metadataidentificationstr metadata identif 
MTHSIG1	buildproxi build proxi 
VARSIG37	path path 
PACKAGE	springframework roo addon gwt 
MTHSIG2	buildrequest build request 
VARSIG36	javatyp type javatyp type 
MTHSIG3	builduixml build xml templatecont templat content destfil dest file 
VARSIG35	javatyp type servertyp server type 
MTHSIG8	getdestinationjavatyp destin type gwttype gwt type gwttype gwt type 
VARSIG30	destinationmetadataid destin metadata 
MTHSIG9	createadditionalannot creat addit annot javatyp type servertyp server type 
CLASSES	gwtmetadata gwt metadata 
VARSIG29	methodmetadata metadata methodmetadata meta data 
VARSIG28	destinationmetadataid destin metadata 
METHODS	gwtmetadata gwt metadata buildproxi build proxi buildrequest build request builduixml build xml transformxml transform xml getrequestmethod request getrequestmethod request getdestinationmetadataid destin metadata getdestinationjavatyp destin type createadditionalannot creat addit annot createannot creat annot getmetadataidentifiertyp metadata identifi type createidentifi creat identifi getjavatyp type getpath path 
VARSIG23	methodmetadata metadata 
VARSIG22	element element 
VARSIG21	element element 
VARSIG20	fieldnam field 
VARSIG27	document document 
VARSIG26	except 
VARSIG25	element 
VARSIG24	element 
VARSIG7	methodmetadata metadata findentriesmethod find entri 
VARSIG6	methodmetadata metadata findmethod find 
VARSIG9	annotationmetadatabuild annot metadata builder annotationbuild annot builder 
VARSIG8	methodmetadata metadata countmethod count 
VARSIG3	list methodmetadata metadata proxymethod proxi method 
VARSIG2	projectmetadata project metadata projectmetadata project metadata 
VARSIG5	methodmetadata metadata findallmethod find 
VARSIG4	list methodmetadata metadata requestmethod request method 
COMMENTS	metadata gwt proxi proxi physicaltypemetadata physic type meta data represent disk proxi creat classorinterfacetypedetailsbuild type detail builder proxi overridden proxi creat add proxyfornam proxi foo bar foo annot add annot don exist target inherit entityproxi entiti proxi extens defin servic employe behaviour gwttype gwt type mirror produc requir mid mirror applic current governor gwttype gwt type mirror produc requir type mirror applic current governor newli creat type annot list complet roogwtmirroredfrom roo gwt mirror annot properli setup 
VARSIG19	fieldnam field 
VARSIG1	classorinterfacetypedetail type detail governortypedetail governor type detail 
VARSIG18	element element 
VARSIG0	identifi 
VARSIG17	element element 
VARSIG12	methodmetadata metadata 
VARSIG11	methodmetadata metadata 
VARSIG10	annotationmetadatabuild annot metadata builder existingannot exist annot 
VARSIG16	systemid system 
VARSIG15	publicid 
VARSIG14	destfil dest file 
VARSIG13	templatecont templat content 
MTHSIG13	getjavatyp type metadataidentificationstr metadata identif 
MTHSIG14	getpath path metadataidentificationstr metadata identif 
MTHSIG11	getmetadataidentifiertyp metadata identifi type 
MTHSIG12	createidentifi creat identifi javatyp type javatyp type path path 
MTHSIG10	createannot creat annot 
VARIABLES	identifi governortypedetail governor type detail projectmetadata project metadata proxymethod proxi method requestmethod request method findallmethod find findmethod find findentriesmethod find entri countmethod count annotationbuild annot builder existingannot exist annot templatecont templat content destfil dest file publicid systemid system element element fieldnam field fieldnam field element element document destinationmetadataid destin metadata methodmetadata meta data destinationmetadataid destin metadata methodmetadata meta data methodreturntyp type gwttype gwt type gwttype gwt type servertyp server type javatyp type path metadataidentificationstr metadata identif metadataidentificationstr metadata identif type type governortypedetail governor type detail projectmetadata project metadata proxymethod proxi method requestmethod request method findallmethod find findmethod find countmethod count findentriesmethod find entri destinationmetadataid destin metadata typedetailsbuild type detail builder typeannot type annot exist method abstractaccessormethodbuild accessor builder propertynam properti abstractmutatormethodbuild mutat builder destinationmetadataid destin metadata typeannot type annot method extendstyp type typedetailsbuild type detail builder builder templatedocu templat document existingdocu exist document existingholdingel exist hold element templateholdingel templat hold element templateelementmap templat element map existingelementmap exist element map elementstoadd element add elementstoremov element remov importednod import node sortedel sort element propertynam properti element transform result sourc methodreturntypearg type methodreturntyp type proxi methodreturntypearg type methodreturntyp type servertypeattribut server type attribut annot roogwtmirroredfromconfig roo gwt mirror config 
