VARSIG7	annotationmetadatabuild annot metadata builder annotationmetadata annot metadata 
VARSIG6	annotationmetadata annot metadata annotationmetadata annot metadata 
VARSIG9	annotationmetadatabuild annot metadata builder builder 
VARSIG8	annotationmetadatabuild annot metadata builder annotationmetadata annot metadata 
VARSIG3	identifiableannotatedjavastructur identifi annot structur exist 
VARSIG2	declaredbymetadataid declaredbi metadata 
VARSIG5	annotationmetadata annot metadata element 
VARSIG4	identifiableannotatedjavastructur identifi annot structur exist 
COMMENTS	assist creation link builder type eventu implement link identifiableannotatedjavastructur identifi annot structur 
VARSIG1	identifiableannotatedjavastructur identifi annot structur exist 
VARSIG0	declaredbymetadataid declaredbi metadata 
MTHSIG4	addannot add annot annotationmetadata annot metadata annotationmetadata annot metadata 
MTHSIG5	addannot add annot annotationmetadatabuild annot metadata builder annotationmetadata annot metadata 
MTHSIG6	onaddannot add annot annotationmetadatabuild annot metadata builder annotationmetadata annot metadata 
VARSIG10	list annotationmetadatabuild annot metadata builder annot 
MTHSIG7	getannot annot 
MTHSIG0	abstractidentifiableannotatedjavastructurebuild identifi annot structur builder declaredbymetadataid declaredbi metadata 
MTHSIG1	abstractidentifiableannotatedjavastructurebuild identifi annot structur builder identifiableannotatedjavastructur identifi annot structur exist 
PACKAGE	springframework roo classpath detail 
MTHSIG2	abstractidentifiableannotatedjavastructurebuild identifi annot structur builder declaredbymetadataid declaredbi metadata identifiableannotatedjavastructur identifi annot structur exist 
MTHSIG3	init identifiableannotatedjavastructur identifi annot structur exist 
MTHSIG8	buildannot build annot 
MTHSIG9	setannot set annot list annotationmetadatabuild annot metadata builder annot 
CLASSES	abstractidentifiableannotatedjavastructurebuild identifi annot structur builder 
METHODS	abstractidentifiableannotatedjavastructurebuild identifi annot structur builder abstractidentifiableannotatedjavastructurebuild identifi annot structur builder abstractidentifiableannotatedjavastructurebuild identifi annot structur builder init addannot add annot addannot add annot onaddannot add annot getannot annot buildannot build annot setannot set annot 
VARIABLES	declaredbymetadataid declaredbi metadata exist declaredbymetadataid declaredbi metadata exist exist element annotationmetadata annot metadata annotationmetadata annot metadata annotationmetadata annot metadata builder annot annot result 
