VARSIG7	physicaltypecategory physical type category physicaltypecategory physical type category
VARSIG6	javatype type
VARSIG9	list javasymbolname symbol enumconstants constants
VARSIG8	classorinterfacetypedetailsbuilder type details builder superclass
VARSIG3	modifier
VARSIG2	declaredbymetadataid declaredby metadata
VARSIG5	physicaltypecategory physical type category physicaltypecategory physical type category
VARSIG4	javatype type
COMMENTS	builder link classorinterfacetypedetails type details
VARSIG1	classorinterfacetypedetails type details existing
VARSIG0	declaredbymetadataid declaredby metadata
MTHSIG4	setname set javatype type
MTHSIG5	getphysicaltypecategory physical type category
VARSIG11	set importmetadata metadata registeredimports registered imports
MTHSIG6	setphysicaltypecategory set physical type category physicaltypecategory physical type category physicaltypecategory physical type category
VARSIG10	javasymbolname symbol javasymbolname symbol
MTHSIG7	getsuperclass superclass
MTHSIG0	classorinterfacetypedetailsbuilder type details builder declaredbymetadataid declaredby metadata
MTHSIG1	classorinterfacetypedetailsbuilder type details builder classorinterfacetypedetails type details existing
PACKAGE	springframework roo classpath details
MTHSIG2	classorinterfacetypedetailsbuilder type details builder declaredbymetadataid declaredby metadata modifier javatype type physicaltypecategory physical type category physicaltypecategory physical type category
MTHSIG3	getname
MTHSIG8	setsuperclass set superclass classorinterfacetypedetailsbuilder type details builder superclass
MTHSIG9	getenumconstants constants
MTHSIG13	getregisteredimports registered imports
MTHSIG14	setregisteredimports set registered imports set importmetadata metadata registeredimports registered imports
MTHSIG11	addenumconstant add constant javasymbolname symbol javasymbolname symbol
MTHSIG12	build
CLASSES	classorinterfacetypedetailsbuilder type details builder
METHODS	classorinterfacetypedetailsbuilder type details builder classorinterfacetypedetailsbuilder type details builder classorinterfacetypedetailsbuilder type details builder getname setname set getphysicaltypecategory physical type category setphysicaltypecategory set physical type category getsuperclass superclass setsuperclass set superclass getenumconstants constants setenumconstants set constants addenumconstant add constant build getregisteredimports registered imports setregisteredimports set registered imports
MTHSIG10	setenumconstants set constants list javasymbolname symbol enumconstants constants
VARIABLES	declaredbymetadataid declaredby metadata existing declaredbymetadataid declaredby metadata modifier physicaltypecategory physical type category physicaltypecategory physical type category superclass enumconstants constants javasymbolname symbol registeredimports registered imports physicaltypecategory physical type category superclass enumconstants constants registeredimports registered imports superclass
