VARSIG7	importregistrationresolver registration resolver resolver
VARSIG6	staticform form
VARSIG9	importregistrationresolver registration resolver resolver
VARSIG8	staticform form
VARSIG3	datatype data type primitive
VARSIG2	array
VARSIG5	list javatype type parameters
VARSIG4	javasymbolname symbol argname arg
COMMENTS	immutable representation type note type contained type formal reference type required convenient ways determine type type simple link converter offered construct javatype type fully qualified type enforced rules listed link link javatypeutils type utils assertjavanamelegal legal letter simple type uppercase fully qualified type include exclude designator fullyqualifiedtypename fully qualified type rules mandatory construct link javatype type full details recall link javatype type immutable setting values fullyqualifiedtypename fully qualified type rules array number array indicies array single dimensional array primitive type representing equivalent primitive argname arg type argument type unassigned parameters type parameters applicable aren disabled roo character isuppercase upper simpletypename simple type charat doesn start uppercase letter let verify starts underscore uppercase simpletypename simple type length character isuppercase upper simpletypename simple type charat simpletypename simple type charat illegalargumentexception illegal argument exception letter type portion uppercase attempted fullyqualifiedtypename fully qualified type periods empty fully qualified complies rules constructor wildcard type parameters list list xxxx list obtains type including type parameters formatted manner compatible type resolution place side free type including parameters legal code empty obtains type including type parameters formatted manner compatible usage passed argument type names attempt resolved automatically registered passed resolver side effects passed resolver staticform form output compatible resolver resolver resolution occur type including parameters legal code empty wasn wildcard details object append isn type arg append object enclosing type enclosing type dot there there enclosing type start handling type foo bar enclosed type handle probability type alpha foo bar letter uppercase treat type normal convention delegating compareto compare efficiency reasons adding fields ensure equals object updated shouldn required javatype type immutable override javatype type clone clonenotsupportedexception clone supported exception javatype type fullyqualifiedtypename fully qualified type array primitive
VARSIG1	fullyqualifiedtypename fully qualified type
VARSIG0	fullyqualifiedtypename fully qualified type
MTHSIG4	getnameincludingtypeparameters including type parameters
VARSIG12	object obj
MTHSIG5	getnameincludingtypeparameters including type parameters staticform form importregistrationresolver registration resolver resolver
VARSIG11	javatype type
MTHSIG6	getnameincludingtypeparameters including type parameters staticform form importregistrationresolver registration resolver resolver map types
VARSIG10	map types
MTHSIG7	getpackage
MTHSIG0	javatype type fullyqualifiedtypename fully qualified type
MTHSIG1	javatype type fullyqualifiedtypename fully qualified type array datatype data type primitive javasymbolname symbol argname arg list javatype type parameters
PACKAGE	springframework roo model
MTHSIG2	getsimpletypename simple type
MTHSIG3	getfullyqualifiedtypename fully qualified type
VARSIG13	javatype type
MTHSIG20	getargname arg
MTHSIG21	getdatatype data type
MTHSIG8	getenclosingtype enclosing type
MTHSIG9	isdefaultpackage
MTHSIG17	equals object obj
MTHSIG18	compareto compare javatype type
MTHSIG15	getarray array
MTHSIG16	getarraysuffix array suffix
MTHSIG13	getparameters parameters
MTHSIG14	isarray array
MTHSIG11	isprimitive primitive
MTHSIG12	iscommoncollectiontype common collection type
CLASSES	javatype type
METHODS	javatype type javatype type getsimpletypename simple type getfullyqualifiedtypename fully qualified type getnameincludingtypeparameters including type parameters getnameincludingtypeparameters including type parameters getnameincludingtypeparameters including type parameters getpackage getenclosingtype enclosing type isdefaultpackage hashcode hash code isprimitive primitive iscommoncollectiontype common collection type getparameters parameters isarray array getarray array getarraysuffix array suffix equals compareto compare tostring getargname arg getdatatype data type
MTHSIG19	tostring
MTHSIG10	hashcode hash code
VARIABLES	fullyqualifiedtypename fully qualified type fullyqualifiedtypename fully qualified type array primitive argname arg parameters staticform form resolver staticform form resolver types obj object object object object object object object object object object primitive primitive primitive primitive primitive primitive primitive primitive primitive parameters argname arg array defaultpackage datatype data type fullyqualifiedtypename fully qualified type simpletypename simple type commoncollectiontypes common collection types offset wildcard wildcard wildcard counter enclosingtype enclosing type offset offset possiblename offset offset enclosedwithinpackage enclosed enclosedwithintypename enclosed type pretypenameportion pre type portion
