VARSIG7	javasymbolname symbol findername finder
VARSIG6	javasymbolname symbol findername finder
VARSIG9	javasymbolname symbol
VARSIG8	methodmetadata metadata
VARSIG3	isdatanucleusenabled data nucleus enabled
VARSIG2	physicaltypemetadata physical type metadata governorphysicaltypemetadata governor physical type metadata
VARSIG5	sortedmap sorted map javasymbolname symbol queryholder query holder queryholders query holders
VARSIG4	methodmetadata metadata entitymanagermethod entity manager
COMMENTS	metadata link rooentity roo entity finders create representation desired output obtains legal dynamic finders metadata instance subset completely empty requested link rooentity roo entity annotation user typing error representing requested dynamic finder field deleted user add produces field mutator loaded error conditions immutable representation finder methods returns empty locates dynamic finder creates demand required requested defined link rooentity roo entity finders exception thrown findername finder dynamic finder user defined generated returns access parameter scan treat match authoritative scan superclass caller expected scan current expected won check parameters create declared field produce accessor entitymanager entity manager roo
VARSIG1	javatype type aspectname aspect
VARSIG0	identifier
MTHSIG4	getmetadataidentifertype metadata identifer type
VARSIG12	path path
MTHSIG5	createidentifier create identifier javatype type javatype type path path
VARSIG11	javatype type javatype type
MTHSIG6	getjavatype type metadataidentificationstring metadata identification
VARSIG10	javasymbolname symbol
MTHSIG7	getpath path metadataidentificationstring metadata identification
MTHSIG0	findermetadata finder metadata identifier javatype type aspectname aspect physicaltypemetadata physical type metadata governorphysicaltypemetadata governor physical type metadata isdatanucleusenabled data nucleus enabled methodmetadata metadata entitymanagermethod entity manager sortedmap sorted map javasymbolname symbol queryholder query holder queryholders query holders
MTHSIG1	getalldynamicfinders dynamic finders
VARSIG15	metadataidentificationstring metadata identification
PACKAGE	springframework roo addon finder
MTHSIG2	getdynamicfindermethod dynamic finder javasymbolname symbol findername finder
VARSIG14	metadataidentificationstring metadata identification
MTHSIG3	tostring
VARSIG13	metadataidentificationstring metadata identification
MTHSIG8	isvalid valid metadataidentificationstring metadata identification
CLASSES	findermetadata finder metadata
METHODS	findermetadata finder metadata getalldynamicfinders dynamic finders getdynamicfindermethod dynamic finder tostring getmetadataidentifertype metadata identifer type createidentifier create identifier getjavatype type getpath path isvalid valid
VARIABLES	identifier aspectname aspect governorphysicaltypemetadata governor physical type metadata isdatanucleusenabled data nucleus enabled entitymanagermethod entity manager queryholders query holders findername finder findername finder javatype type path metadataidentificationstring metadata identification metadataidentificationstring metadata identification metadataidentificationstring metadata identification type type entity manager entitymanagermethod entity manager queryholders query holders isdatanucleusenabled data nucleus enabled dynamicfindermethods dynamic finder methods methodmetadata metadata parameters querytype query type typedquerytype typed query type queryholder query holder jpaquery jpa query parametertypes parameter types parameternames parameter names bodybuilder body builder methodname containscollectiontype collection type length collectiontypenames collection type names jpaquerycomplete jpa query complete position methodbuilder builder tsc
