VARSIG7	gwttype gwt type type
VARSIG6	gwttype gwt type gwttype gwt type
VARSIG9	destfile dest file
VARSIG8	classorinterfacetypedetails type details type
VARSIG3	methodmetadata metadata
VARSIG2	metadataidentificationstring metadata identification
VARSIG5	methodmetadata metadata proxymethod proxy
VARSIG4	toget
COMMENTS	monitors types creates updates deletes gwt files maintained mirror compatible object find list mirror compatible objects link gwttype gwt type rooentity roo entity instances mirror compatible roo add ons provider aims expose contents files link gwtmetadata gwt metadata attempts avoiding writing disk separate type monitors creation deletion aforementioned files maintain global indexes abort early can start converting mid concept governor mid refers governor abort file source path interested source client governor governor interested types verify mid passed corresponds type general strategy instantiate gwtmetadata gwt metadata offers conceptual representation key specific types comparisons write disk needed physical type changed determine local metadata identification proceed downstream dependency relationship registered registered event delivered instance specific downstream dependency processed
VARSIG19	methodmetadata metadata findallmethod find
VARSIG1	componentcontext component context context
VARSIG18	methodmetadata metadata findmethod find
VARSIG0	componentcontext component context context
VARSIG17	methodmetadata metadata findentriesmethod find entries
MTHSIG4	notify upstreamdependency upstream dependency downstreamdependency downstream dependency
VARSIG12	classorinterfacetypedetails type details templatetypedetail template type detail
MTHSIG5	ismappable mappable typename type memberdetails member details memberdetails member details methodmetadata metadata findentriesmethod find entries methodmetadata metadata findmethod find methodmetadata metadata findallmethod find methodmetadata metadata countmethod count
VARSIG11	gwttype gwt type type
MTHSIG6	createlocalidentifier create local identifier javatype type javatype type path path
VARSIG10	destfile dest file
MTHSIG7	getprovidestype type
MTHSIG0	activate componentcontext component context context
VARSIG16	memberdetails member details memberdetails member details
MTHSIG1	deactivate componentcontext component context context
VARSIG15	typename type
PACKAGE	springframework roo addon gwt
MTHSIG2	metadataidentificationstring metadata identification
VARSIG14	downstreamdependency downstream dependency
MTHSIG3	buildtype build type gwttype gwt type type
VARSIG13	upstreamdependency upstream dependency
CLASSES	gwtmetadataproviderimpl gwt metadata provider impl
METHODS	activate deactivate buildtype build type notify ismappable mappable createlocalidentifier create local identifier getprovidestype type
VARSIG22	path path
VARSIG21	javatype type javatype type
VARSIG20	methodmetadata metadata countmethod count
VARIABLES	context context metadataidentificationstring metadata identification toget proxymethod proxy gwttype gwt type type type destfile dest file destfile dest file type templatetypedetail template type detail upstreamdependency upstream dependency downstreamdependency downstream dependency typename type memberdetails member details findentriesmethod find entries findmethod find findallmethod find countmethod count javatype type path logger filemanager file manager gwtfilemanager gwt file manager gwttemplateservice gwt template service gwttypeservice gwt type service memberdetailsscanner member details scanner metadataservice metadata service metadatadependencyregistry metadata dependency registry projectoperations project operations dependson depends cannotmap map projectmetadata project metadata governortypename governor type governortypepath governor type path physicaltypeid physical type governorphysicaltypemetadata governor physical type metadata governortypedetails governor type details memberdetails member details persistencememberholdingtypedetails persistence member holding type details findentriesmethod find entries findmethod find findallmethod find countmethod count proxymethods proxy methods convertedproxymethods converted proxy methods dependsonsomething depends returntype type proxytype proxy type ptmd set gwttype gwt type methodbuilder builder convertedmethod converted sourcepaths source paths requestmethods request methods gwtmetadata gwt metadata toremove remove toalert alert clientsidetypemap client side type map propertyname property propertytype property type ptmd field annotations gwtproxyproperty gwt proxy property templatedataholder template data holder typestobewritten types written xmltobewritten xml written mirrortypemap mirror type map extendstypes types destfile dest file contents projectmetadata project metadata watchedmethods watched methods templatetypedetails template type details typestobewritten types written projectmetadata project metadata typename type typepath type path persistmethod persist removemethod remove identifieraccessormethod identifier accessor versionaccessormethod version accessor versionfields version fields
