VARSIG7	physicaltypemetadata physic type metadata governorphysicaltypemetadata governor physic type metadata 
VARSIG6	javatyp type aspectnam aspect 
VARSIG9	list identifi identifierserviceresult identifi servic result 
VARSIG8	identifierannotationvalu identifi annot valu annotationvalu annot valu 
VARSIG3	metadataidentificationstr metadata identif 
VARSIG2	metadataidentificationstr metadata identif 
VARSIG5	identifi 
VARSIG4	metadataidentificationstr metadata identif 
COMMENTS	metadata link rooidentifi roo identifi link identifierservic identifi servic popul link identifiermetadataproviderimpl identifi metadata provid impl add embedd annot add declar field accessor mutat parameteris constructor arg constructor provid add custom data tag roo identifi type creat represent desir output locat accessor method link getfieldbuild field builder return field creat accessor automat produc declar field accessor return comput name accessor produc add length attribut string add precis scale attribut numer field locat declar field parent defin locat creat declar field return field return locat declar field add field annot add field declar governor remov field modifi remov field annot creat identifi field comput column requir locat mutat method link getfieldbuild field builder return field creat mutat automat produc declar field mutat return comput name mutat produc locat arg constructor defin arg constructor return irrespect access modifi defin arg constructor creat creat link rooidentifi roo identifi noargconstructor arg constructor constructor declar sourc file constructor creat access modifi constructor constructor produc search exist constructor exist arg constructor creat constructor locat parameteris constructor consist field field constructor search exist constructor exist parameteris constructor creat constructor add jsr tempor annot field roo 
VARSIG19	fieldmetadatabuild field metadata builder field 
VARSIG1	logicalpath logic path path 
VARSIG18	list fieldmetadatabuild field metadata builder field 
VARSIG0	javatyp type javatyp type 
VARSIG17	fieldmetadata field metadata field 
MTHSIG4	isvalid valid metadataidentificationstr metadata identif 
VARSIG12	methodmetadatabuild metadata builder mutat 
MTHSIG5	identifiermetadata identifi metadata identifi javatyp type aspectnam aspect physicaltypemetadata physic type metadata governorphysicaltypemetadata governor physic type metadata identifierannotationvalu identifi annot valu annotationvalu annot valu list identifi identifierserviceresult identifi servic result 
VARSIG11	methodmetadatabuild metadata builder accessor 
MTHSIG6	getaccessor accessor list fieldmetadatabuild field metadata builder field 
VARSIG10	fieldmetadatabuild field metadata builder field 
MTHSIG7	getcolumnbuild column builder identifi identifi 
MTHSIG0	createidentifi creat identifi javatyp type javatyp type logicalpath logic path path 
VARSIG16	identifi identifi 
MTHSIG1	getjavatyp type metadataidentificationstr metadata identif 
VARSIG15	identifi identifi 
PACKAGE	springframework roo addon jpa identifi 
MTHSIG2	getmetadataidentifiertyp metadata identifi type 
VARSIG14	fieldmetadatabuild field metadata builder field 
MTHSIG3	getpath path metadataidentificationstr metadata identif 
VARSIG13	list fieldmetadatabuild field metadata builder field 
MTHSIG8	getembeddableannot embedd annot 
MTHSIG9	getfieldbuild field builder 
MTHSIG13	hasfield field list fieldmetadata field metadata declaredfield declar field fieldmetadata field metadata idfield field 
MTHSIG14	setdateannot set annot columndefinit column definit list annotationmetadatabuild annot metadata builder annot 
MTHSIG11	getnoargconstructor arg constructor 
MTHSIG12	getparameterizedconstructor parameter constructor list fieldmetadatabuild field metadata builder field 
CLASSES	identifiermetadata identifi metadata 
METHODS	createidentifi creat identifi getjavatyp type getmetadataidentifiertyp metadata identifi type getpath path isvalid valid identifiermetadata identifi metadata getaccessor accessor getcolumnbuild column builder getembeddableannot embedd annot getfieldbuild field builder getmut mutat getnoargconstructor arg constructor getparameterizedconstructor parameter constructor hasfield field setdateannot set annot 
VARSIG23	list fieldmetadata field metadata declaredfield declar field 
VARSIG22	fieldmetadatabuild field metadata builder field 
VARSIG21	fieldmetadatabuild field metadata builder field 
VARSIG20	list fieldmetadatabuild field metadata builder field 
VARSIG27	list annotationmetadatabuild annot metadata builder annot 
VARSIG26	columndefinit column definit 
VARSIG25	fieldmetadata field metadata declaredfield declar field 
VARSIG24	fieldmetadata field metadata idfield field 
MTHSIG10	getmut mutat list fieldmetadatabuild field metadata builder field 
VARIABLES	javatyp type path metadataidentificationstr metadata identif metadataidentificationstr metadata identif metadataidentificationstr metadata identif identifi aspectnam aspect governorphysicaltypemetadata governor physic type metadata annotationvalu annot valu identifierserviceresult identifi servic result field accessor mutat field field identifi identifi field field field field field field declaredfield declar field idfield field declaredfield declar field columndefinit column definit annot type type identifierserviceresult identifi servic result publicnoargconstructor arg constructor field accessor requiredaccessornam requir accessor accessor columnbuild column builder annotationbuild annot builder declaredfield declar field field annot idfield field iter field transientannotatedfield annot field fieldbuild field builder annot columnbuild column builder mutat requiredmutatornam requir mutat parametertyp paramet type mutat parametertyp paramet type result bodybuild bodi builder constructorbuild constructor builder parametertyp paramet type result parameternam paramet name bodybuild bodi builder fieldnam field constructorbuild constructor builder temporaltyp tempor type temporalbuild tempor builder datetimeformatbuild time format builder 
