VARSIG39	classorinterfacetypedetailsbuild type detail builder innertyp type 
MTHSIG4	getrequestmethod request method classorinterfacetypedetail type detail governortypedetail governor type detail 
VARSIG34	javasymbolnam symbol fieldnam field 
MTHSIG5	isvalidmethodreturntyp valid type methodmetadata metadata memberholdingtypedetail member hold type detail memberholdingtypedetail member hold type detail 
VARSIG33	list memberholdingtypedetail member hold type detail extendstyp type 
MTHSIG6	ismethodreturntypesinsourcepath type sourc path methodmetadata metadata memberholdingtypedetail member hold type detail memberholdingtypedetail member hold type detail list sourcepath sourc path 
VARSIG32	classorinterfacetypedetail type detail templateclass templat 
MTHSIG7	isdomainobject domain object javatyp type type 
VARSIG31	gwttype gwt type desttyp dest type 
MTHSIG0	getgwtsideleaftyp gwt side leaf type javatyp type type projectmetadata project metadata projectmetadata project metadata javatyp type governortyp governor type requesttyp request type 
VARSIG38	javatyp type innertypenam type 
MTHSIG1	getextendstyp type classorinterfacetypedetail type detail childtyp child type 
VARSIG37	methodmetadatabuild metadata builder methodbuild builder 
PACKAGE	springframework roo addon gwt 
MTHSIG2	getsourcepath sourc path 
VARSIG36	javasymbolnam symbol methodnam 
MTHSIG3	getproxymethod proxi method classorinterfacetypedetail type detail governortypedetail governor type detail 
VARSIG35	fieldmetadatabuild field metadata builder fieldbuild field builder 
MTHSIG8	createabstractbuild creat builder classorinterfacetypedetailsbuild type detail builder concreteclass concret list memberholdingtypedetail member hold type detail extendstypesdetail type detail 
VARSIG30	javasymbolnam symbol paramnam 
MTHSIG9	buildtyp build type gwttype gwt type desttyp dest type classorinterfacetypedetail type detail templateclass templat list memberholdingtypedetail member hold type detail extendstyp type 
CLASSES	gwttypeserviceimpl gwt type servic impl 
VARSIG29	javatyp type typetyp type type 
VARSIG28	annotatedjavatyp annot type type 
METHODS	getgwtsideleaftyp gwt side leaf type getextendstyp type getsourcepath sourc path getproxymethod proxi method getrequestmethod request method isvalidmethodreturntyp valid type ismethodreturntypesinsourcepath type sourc path isdomainobject domain object createabstractbuild creat builder buildtyp build type displaywarn displai warn isallowablereturntyp allow type isallowablereturntyp allow type iscommontyp common type isprimit primit isent entiti isenum getprojectmetadata project metadata 
VARSIG23	javatyp type type 
VARSIG22	sourcepath sourc path 
VARSIG21	list sourcepath sourc path 
VARSIG20	memberholdingtypedetail member hold type detail memberholdingtypedetail member hold type detail 
VARSIG27	constructormetadata constructor metadata constructormetadata constructor metadata 
VARSIG26	memberholdingtypedetail member hold type detail extendstypedetail type detail 
VARSIG25	list memberholdingtypedetail member hold type detail extendstypesdetail type detail 
VARSIG24	classorinterfacetypedetailsbuild type detail builder concreteclass concret 
VARSIG7	systemid system 
VARSIG6	publicid 
VARSIG9	ioexcept except 
VARSIG8	except 
VARSIG3	requesttyp request type 
VARSIG2	javatyp type governortyp governor type 
VARSIG5	javatyp type javatyp type 
VARSIG4	classorinterfacetypedetail type detail childtyp child type 
COMMENTS	basic implement link gwttypeservic gwt type servic type arg client side domain type domainmethodreturntyp domain type list set return domainmethodreturntyp domain type list list type projectmetadata project metadata governortyp governor type gwt side leaf type javatyp type behaviour type consist concret type depend 
VARSIG19	methodmetadata metadata 
VARSIG1	projectmetadata project metadata projectmetadata project metadata 
VARSIG18	memberholdingtypedetail member hold type detail memberholdingtypedetail member hold type detail 
VARSIG0	javatyp type type 
VARSIG17	methodmetadata metadata 
VARSIG12	memberholdingtypedetail member hold type detail memberholdingtypedetail member hold type detail 
VARSIG11	classorinterfacetypedetail type detail governortypedetail governor type detail 
VARSIG10	element sourcepathel sourc path element 
VARSIG16	methodmetadata metadata 
VARSIG15	memberholdingtypedetail member hold type detail memberholdingtypedetail member hold type detail 
VARSIG14	classorinterfacetypedetail type detail governortypedetail governor type detail 
VARSIG13	methodmetadata metadata 
MTHSIG17	getprojectmetadata project metadata 
MTHSIG15	isent entiti javatyp type type 
MTHSIG16	isenum javatyp type type 
MTHSIG13	iscommontyp common type javatyp type type 
MTHSIG14	isprimit primit javatyp type type 
MTHSIG11	isallowablereturntyp allow type methodmetadata metadata 
MTHSIG12	isallowablereturntyp allow type javatyp type type 
VARSIG45	javatyp type type 
VARSIG44	javatyp type type 
VARSIG43	javatyp type type 
VARSIG42	methodmetadata metadata 
VARSIG47	javatyp type type 
VARSIG46	javatyp type type 
MTHSIG10	displaywarn displai warn warn 
VARIABLES	type projectmetadata project metadata governortyp governor type requesttyp request type childtyp child type javatyp type publicid systemid system sourcepathel sourc path element governortypedetail governor type detail memberholdingtypedetail member hold type detail governortypedetail governor type detail memberholdingtypedetail member hold type detail memberholdingtypedetail member hold type detail memberholdingtypedetail member hold type detail sourcepath sourc path sourcepath sourc path type concreteclass concret extendstypesdetail type detail extendstypedetail type detail constructormetadata constructor metadata type typetyp type type paramnam desttyp dest type templateclass templat extendstyp type fieldnam field fieldbuild field builder methodnam methodbuild builder innertypenam type innertyp type warn type type type type type logger metadataservic metadata servic memberdetailsscann member detail scanner projectoper project oper filemanag file manag warn warningtim warn timer elementtyp element type ptmd extendstyp type supertypeid type supertyp type gwtxml gwt xml mutablegwtxml mutabl gwt xml gwtxmldoc gwt xml doc builder gwtxmlroot gwt xml root sourcepath sourc path sourcepathel sourc path element path proxymethod proxi method memberholdingtypedetail member hold type detail memberholdingtypedetail member hold type detail requestmethod request method entitymetadata entiti metadata gwttype gwt type methodbuild builder returntyp type propertynam properti propertytyp properti type insourcepath sourc path collectiontypeinsourcepath collect type sourc path ptmd concretetyp concret type abstractnam abstracttyp type abstractid builder abstractconstructor constructor typemap type map newtyp type paramtyp type typeparam type bodybuild bodi builder type templateclassbuild templat builder abstractclassbuild builder fieldstoremov field remov abstractfieldbuild field builder methodstoremov method remov abstractmethodbuild builder builder innertypebuild type builder ptmd annotationmetadata annot metadata 
VARSIG41	warn 
VARSIG40	except 
